#####
#  @####
#  o.  #
## o.# #
#  o.# #
#  o.  #
#    ###
######