   #####
   #   #
####   #
# . .  #
#  .   #
# .  o ##
##   oo #
 ##  o@ #
  ##  ###
   ####
