####
#  ###
#    #
# o  #
#     #
# o o #
#..@..#
#  o  #
###  ##
  ####